SUN = "countries/Sunset.txt"
SAD = "countries/Adartho.txt"
SHA = "countries/Hasona.txt"
SGL = "countries/Glr.txt"
SOC = "countries/Ocros.txt"
SPA = "countries/Spaa.txt"
SHM = "countries/Westz.txt"
FRB = "countries/Majestaz.txt"
NCC = "countries/NewConlangia.txt"
MSR = "countries/MakyanSunset.txt"
KCM = "countries/Gospel.txt"
PGR = "countries/PagansRising.txt"
FTP = "countries/Ftopia.txt"
MRP = "countries/MemeRP.txt"
GLR = "countries/GlrDictatorship.txt"
NAZ = "countries/NaZaDespotate.txt"
EUM = "countries/EuMod.txt"
TSR = "countries/Tesseract.txt"
TVO = "countries/Vura.txt"
FMC = "countries/Fmc.txt"
NYA = "countries/Nyanker.txt"
CEU = "countries/Ceu.txt"
CLD = "countries/Contlore.txt"
MPL = "countries/Meplora.txt"
LAS = "countries/Lasima.txt"
SAR = "countries/Penguin.txt"
SAU = "countries/Timeline.txt"
BRT = "countries/Redcoat.txt"

NEU = "countries/Neutral.txt"

CHN = "countries/Novvan.txt"
CHI = "countries/Nico.txt"
CHO = "countries/Ogfortnite.txt"
CHS = "countries/SunsetS.txt"
CHR = "countries/Rag.txt"
CHH = "countries/Hugo.txt"
CHF = "countries/Fish.txt"
CHK = "countries/Kcm.txt"
CHA = "countries/Andrew.txt"
CHB = "countries/Bedzi.txt"
CHM = "countries/Skm.txt"
CHE = "countries/Saurie.txt"
CHL = "countries/Meme.txt"
CHZ = "countries/Naza.txt"
CHC = "countries/Bacon.txt"

NC1 = "countries/ConlangUnion.txt"
NC2 = "countries/Cami.txt"